10 10 
S.#.......
#.........
#.........
.....#....
..........
.#........
..........
#.........
.#.....#..
.......#.f
