30 30
S.#.......#...................
#.........#...................
#.........#...................
.....#....#...................
.....##...#...................
.#........#...................
.................####.........
#.............................
.#.....#......................
.......#......................
..#.................###...#...
######.......#................
#.............................
.....#........................
..............................
.#..####........#####.........
...........###................
#.............................
.#.....#............####......
.......#.......#..#...........
..#...........................
#.............#.##............
#..###.................###....
.....#.....###................
..............................
.#..............##............
....####......................
#.....................######..
.#.....#......................
.......#................####F.
